................................
................................
................................
................................
.....................PPPPPPP....
................................
................................
....PPPPP.......................
................................
................................
................................
................................
............PPPP................
................................
................................
................................
................................
................................
................................
................................
................................
................................
................................
--------------------------------